まうりすてふぁにー	馬瓜ステファニー	人名
かわいまい	川井麻衣	人名
さとうきょうか	佐藤京香	人名
ひらしたあいか	平下愛佳	人名
みやしたきほ	宮下希保	人名
うめきちなつ	梅木千夏	人名
やまもとまい	山本麻衣	人名
うめざわかでぃしゃじゅな	梅沢カディシャ樹奈	人名
しらそはなふぁとーじゃ	シラソハナファトージャ	人名
おがさわらみな	小笠原美奈	人名
ひらのみつき	平野実月	人名
おかだえり	岡田英里	人名
あかぎりほ	赤木里帆	人名
まちだるい	町田瑠唯	人名
おくいぶき	奥伊吹	人名
たなかまみこ	田中真美子	人名
やましたしおり	山下詩織	人名
ふじもとあき	藤本愛妃	人名
なかむらゆにか	中村優花	人名
わたなべゆう	渡邊悠	人名
うちおあきな	内尾聡菜	人名
えらもえか	江良萌香	人名
みやざわゆき	宮澤夕貴	人名
おこえもにか	オコエ桃仁花	人名
おくやまりりか	奥山理々嘉	人名
ながおかもえこ	長岡萌映子	人名
ふじもとまこ	藤本愛瑚	人名
はやしさき	林咲希	人名
はなしまももか	花島百香	人名
とかしきらむ	渡嘉敷来夢	人名
おかもとさやか	岡本彩也花	人名
さとうゆか	佐藤由佳	人名
もはめどふぁてぃまとぅさやか	モハメドファティマトゥ早野夏	人名
さんたなな	三田七南	人名
まかべあやの	真壁あやの	人名
たかだしずか	高田静	人名
ろーやしん	ローヤシン	人名
みやざきさおり	宮崎早織	人名
なかだたまみ	中田珠未	人名
ほしあんり	星杏璃	人名
ふじおかまなみ	藤岡麻菜美	人名
こいけはるか	小池遥	人名
かねだまな	金田愛奈	人名
はしぐちいつき	橋口樹	人名
たにむらりか	谷村里佳	人名
ちなゆうり	知名祐里	人名
よしだまい	吉田舞衣	人名
ちばあゆみ	千葉歩	人名
のぐちさくら	野口さくら	人名
ぱれいるせあねへいららのりこ	パレイルセアネヘイララ紀子	人名
おおぬまみこと	大沼美琴	人名
みやさかももな	宮坂桃菜	人名
きたむらゆうき	北村悠貴	人名
みずのひなの	水野妃奈乃	人名
さとうゆりか	佐藤由璃果	人名
くりばやしみわ	栗林未和	人名
たじまゆきな	田嶋優希奈	人名
もとかわさなえ	本川紗奈生	人名
たかはしみく	高橋未来	人名
たかだまき	高田真希	人名
わたべゆりな	渡部友里奈	人名
あかほさくら	赤穂さくら	人名
きむらあみ	木村亜美	人名
もりむちゃ	森ムチャ	人名
しのはらはなみ	篠原華実	人名
ばいくんばでぃやさん	バイクンバディヤサン	人名
みぐちまつり	美口まつり	人名
ながたもえ	永田萌絵	人名
あかほひまわり	赤穂ひまわり	人名
いいじまさき	飯島早紀	人名
おかだまなみ	岡田真那美	人名
ささかみき	佐坂樹	人名
とうどうななこ	東藤なな子	人名
ひらしたゆき	平下結貴	人名
さきはらなるみ	崎原成美	人名
ぺくきょんふぁ	白慶花	人名
ひらすえあすか	平末明日香	人名
かとうゆうき	加藤優希	人名
さいとうまみ	齋藤麻未	人名
いはみそら	伊波美空	人名
ふかいゆめ	深井夢	人名
さかもとみき	坂本美樹	人名
おどぼえんでゅらんす	オドボエンデュランス	人名
かわむらみゆき	河村美幸	人名
だふぇはでぃ	ダフェハディ	人名
ながいゆいな	永井唯菜	人名
ねもとはるの	根本葉瑠乃	人名
こすげゆか	小菅由香	人名
みさきみなみ	見崎南美	人名
おおさきまな	大崎万菜	人名
にしおかりさ	西岡里紗	人名
さがあいは	佐賀藍葉	人名
かさぎはるな	笠置晴菜	人名
みまるい	三間瑠依	人名
ふじたのどか	藤田和	人名
わたなべあや	渡邉亜弥	人名
はまぐちきょうこ	濱口京子	人名
だらーめまれむどい	ダラーメマレムドイ	人名
ほしかなえ	星香那恵	人名
しらさやゆうり	白鞘郁里	人名
よもぎたまゆ	蓬田麻友	人名
ふにゅうはるか	船生晴香	人名
むらやまみどり	村山翠	人名
せきななみ	関ななみ	人名
おにづかあやの	鬼塚彩乃	人名
つるみあや	鶴見彩	人名
わしんとんにしき	ワシントン錦	人名
さとうななみ	佐藤奈々美	人名
やまぐちりな	山口里奈	人名
おおはらさおり	大原咲織	人名
なかのゆき	中野由希	人名
ほしざわまこと	星澤真	人名
じくまるひかる	軸丸ひかる	人名
もとはしなこ	本橋菜子	人名
かばしまほたる	樺島ほたる	人名
たかのはしきみか	鷹のはし公歌	人名
おざきさやこ	尾崎早弥子	人名
しぶやさつき	澁谷咲月	人名
つむらゆりこ	津村ゆり子	人名
たかはらはるき	高原春季	人名
みずのなほ	水野菜穂	人名
あわつゆきの	粟津雪乃	人名
おくだはな	奥田花	人名
とみだあいり	富田愛理	人名
せやまかえで	瀬山楓	人名
こなてかでぃじゃ	コナテカディジャ	人名
わかはらまなみ	若原愛美	人名
はまにしななみ	濱西七海	人名
なかやまあやな	中山彩奈	人名
かたやまなな	片山菜々	人名
おかもえの	岡萌乃	人名
つちだほのか	土田帆乃香	人名
いしかわあすか	石川明日香	人名
いしだゆづき	石田悠月	人名
いしかわあい	石川愛	人名
わたなべまなか	渡邊愛加	人名
いではらなつき	出原菜月	人名
かわばたひなこ	川端日菜子	人名
しのみやあんな	篠宮杏奈	人名
のまちさきこ	野町紗希子	人名
おおさわらあや	大澤来彩	人名
よねやほのか	米谷帆芽	人名
こんどうみやこ	近藤京	人名
すながわなつき	砂川夏輝	人名
やまぐちななか	山口奈々花	人名
うめだあやか	梅田彩香	人名
わきりなの	脇梨奈乃	人名
うえながみな	上長美菜	人名
みねはるじゅね	峰晴寿音	人名
さかいさら	酒井彩等	人名
やまもとゆま	山本由真	人名
かようりかこ	嘉陽梨佳子	人名
こはまなつみ	小濱菜摘	人名
たまだなな	玉田那奈	人名
きたがわあいり	北川愛理	人名
にあんんでぃくんば	ニアンンディクンバ	人名
かわせひとみ	河瀬ひとみ	人名
たかのゆずき	高野柚希	人名
ひらまつあすか	平松飛鳥	人名
おざわあやか	小澤彩佳	人名
かかずゆい	嘉数唯	人名
おくむらりん	奥村鈴	人名
たなかようこ	田中陽子	人名
さとうひかる	佐藤ひかる	人名
さとうちひろ	佐藤千裕	人名
たかはしゆうか	高橋悠佳	人名
さかたゆきな	坂田侑紀奈	人名
なかやまいつき	中山樹	人名
きたがわなおみ	北川直美	人名
やのひろみ	矢野祐未	人名
ささかみのん	佐坂明音	人名
にしたるみずみお	西垂水美桜	人名
かなざわみどり	金沢みどり	人名
ようもとまゆ	陽本麻優	人名
たむらあおい	田村碧衣	人名
くめなつみ	久米捺美	人名
あらいねね	新井希寧	人名
なかむらかのん	中村華祈	人名
かわむらみゆ	河村美侑	人名
いいぐまあいり	飯隈愛理	人名
やのさやか	矢野紗也佳	人名
たかぎしほ	高木志歩	人名
くろぬまさきほ	黒沼咲百	人名
あでぃあういあこえらりやばばあーめど	アディアウイアコエラリヤババアーメド	人名
しらさきみなみ	白崎みなみ	人名
ぶんやももか	文屋萌々華	人名
かまだゆめ	鎌田有芽	人名
やまぐちふみの	山口史乃	人名
おかむらゆみ	岡村優美	人名
よしださおり	吉田沙織	人名
すながあさみ	須永麻美	人名
ひぐちしほ	樋口栞帆	人名
とおやまかな	遠山佳奈	人名
やのなぎさ	矢野凪紗	人名
やまもとみく	山本美空	人名
うえたのあ	植田希歩	人名
